000000000000000000000000000000000000000000000000000000000
000000000000000000000030000000000000000000000000000000000
000000000000000300011122110000000000000000000000000000000
000000000001000200000000000000000000000000000003022000000
000000000000000000000000000000000000000000000012111110000
000000030000003000000000000000000000000000000000000000000
000210022112112110000000000000000021111110000000000000000
000000000000000000000000000000000000000000000000000000000
000000000000000000000000000000303000000000000000000000000
000300033300000000000000011122222111111111000000000000000
112222222221110000300111111111111111111111111222000000011
111111111111112222221111111111111111111111111111111111111
111111111111111111111111111111111111111111111111111111111
